20
8
0  0  0  0  0  0  0 21
0  0  0  0  0  0 11 21
0  0  0  0  0  0  0 21
0  0  0  0  0  0 26  1
0  0  0  0  0  0 27  2
0  0  0  0  0  0  0 21
0  0  0  0  0  0  0 21
0  0  0  0  0  0 30  3
0  0  0  0  0  0  0 21
0  0  0  0  0  0 10 21
0  0  0  0  0  0  0 21
0  0  0  0  0  0 30  3
0  0  0  0  0  0  0 21
0  0  0  0  0  0  0 21
0  0  0  0  0  0  0 21
0  0  0  0 30 33 31  1
0  0  0  0  0  9 21 22
0  0  0  0  0  0 21 22
0  0  0  0  0 30 32  2
0  0  0  0  0  0  0 21