20
8
0  0  0  0  0  0  0 21
0  0  0 23  0  0  0 21
0  0  0 24  0  0 26  1
0  0  0 25  0  0 21 22
0  0  0  0  0  9 27  2
0  0  0  0  0  0  0 21
0  0  0  0  0  0  0 21
0  0  0  0  0  0 26  1
0  0  0  0  0  0 21 22
0  0  0  0 11 30 32  2
0  0  0  0  0  0  0 21
0  0  0  0  0  0 30  3
0  0  0  0  0  0  0 21
0  0  0  0  0  0  0 21
0  0  0  0  0  0  0 21
0  0  0  0  0 30 31  1
0  0  0  0  0  9 21 22
0  0  0  0  0  0 21 22
0  0  0  0  0 30 32  2
0  0  0  0  0  0  0 21