20
8
0  0  0  0  0  0  0 21
0  0  0  0  0  0  0 21
0  0  0  0  0  0 21 21
0  0  0  0  0  0 21 21
0  0  0  0  0  0 21 21
0  0  0  0  0  0 21 21
0  0  0  0  0 21 21 21
0  0  0  0  0 21 21 21
0  0  0  0  0 21 21 21
0  0  0  0 21 21 21 21
0 23  0  0 21 21 21 21
0 25  0  0  0 21 21 21
0  0  0  0  0 21 21 21
0  0  0  0 21 21 21 21
0  0  0 21 21 21 21 21
0  0  0 21 21 21 21 21
0  0  0 21 21 21 21 21
0  0 21 21 21 21 21 21
0  0  0  0  0 21 21 21
0  0  0  0  0  0  0 21