20
8
0  0  0  0  0  0  0 21
0  0  0  0  0  0  0 21
0  0  0  0  0  0  0 21
0  0  0  0  0  0  0 21
0  0  0  0  0  0  0 21
0  0  0  0  0  0  0 21
0  0  0  0  0  0  0 21
0  0  0  0  0  0  0 21
0  0  0  0  0  0  0 21
0  0  0  0  0  0  0 21
0  0  0  0  0  0  0 21
0  0  0  0  0  0  0 21
0  0 12  0  0  0  0 21
0  0 13  0  0  0  0 21
0  0 14  0  0  0  0 21
0  0  0  0  0  0  0 21
0  0  0  0  0  0  0 21
0  0  0 15  0  0  0 21
0  0  0 16  0  0  0 21
0  0  0  0  0  0  0 21