40
8
0  0  0  0  0  0  0 21
0  0  0  0  0  0 26  1
0  0  0  0 26 28  1 22
0  0  0  9 21 22 22 22
0  0  0  0 21 22 22 22
0  0  0  0 21 22 22 22
0  0  0 26  1 22 22 22
0  0  0 21 22 22 22 22
0 10 26  1 22 22 22 22
0  0 27 29  2 22 22 22
0  0  0  0 21 22 22 22
0  0  0  0 27 29 29  2
0  0  0  0  0  0  0 21
0  0  0  0  0  0  0 21
0  0  0  0  0  0  0 27
0  0  0  0  0  0  0  0
0  0  0  0  0  0  0  0
0  0  0  0  0  0  0  0
0  0  0  0  0  0  0 26
0  0  0  0  0  0  0 27
0  0  0  0  0  0  0  0
0  0  0  0  0  0  0  0
0  0  0  0  0  0  0  0
0  0  0  0  0  0  0  0
0  0  0  0  0  0 26 28
0  0  0  0 26 28  1 22
0  0  0 26  1 22 22 22
0  0  0 27 29  2 22 22
0  0  0  0  0 27  2 22
0  0  0  0  0  0 21 22
0  0  0  0  0  0 21 22
0  0  0  0  0 26  1 22
0  0  0 26 28  1 22 22
0  0  0 27  2 22 22 22
0  0  0  0 21 22 22 22
0  0  0  0 21 22 22 22
0  0  0  0 27 29  2 22
0  0  0  0  0  0 21 22
0  0  0  0  0  0 27  2
0  0  0  0  0  0  0 21