20
8
0  0  0  0  0  0  0 21
0  0  0  0  0  0  0 21
0  0  0  0  0  0 26  1
0  0  0  0  9 30  1 22
0  0  0  0  0  0 21 22
0  0  0  0  0  0 27  2
0  0  0  0  0  0  0 21
0  0  0  0  0  0  0 21
0  0  0  0  0  0  0 21
0  0  0  0  0  0 26  1
0  0  0  0  0 26  1 22
0  0  0 11 26  1 22 22
0  0  0 26  1 22 22 22
0  0 26  1 22 22 22 22
0 26  1 22 22 22 22 22
0 21 22 22 22 22 22 22
0 27 29 29 29 29 29  2
0  0  0  0  0  0  0 21
0  0  0  0  0  0  0 21
0  0  0  0  0  0  0 21