20
8
0  0  0  0  0  0  0 21
0  0  0 23  0  0  0 21
0  0  0 24  0  0 26  1
0  0  0 25  0  0 21 22
0  0  0  0  0  0 27  2
0  0  0  0  0  0  0 21
0  0  0  0  0  0  0 21
0  0  0  0  0  0 26  1
0  0  0  0  0  0 21 22
0  0  0  0  0 30 29  2
0  0  0  0  0  0  0 21
0  0  0  0  0  0 21  3
0  0  0  0  0  0  0 21
0  0  0  0  0  0  0 21
0  0  0  0  0  0  0 21
0  0  0  0  0 30 28  1
0  0  0  0  0  0 21 22
0  0  0  0  0  0 21 22
0  0  0  0  0 30 29  2
0  0  0  0  0  0  0 21