20
8
0  0  0  0  0  0  0 21
0  0  0  0  0  0  0 21
0  0  0  0  0  0 26  1
0  0  0  0  0  9 21 22
0  0  0  0  0  0 21 22
0  0  0  0  0  0 27 29
0  0  0  0  0  0  0  0
0  0  0  0  0  0  0  0
0  0  0  0  0  0 26 28
0  0  0  0  0 11 21 22
0  0  0  0  0 30 32  2
0  0  0  0  0  0  0 21
0  0  0  0  0  0  0 27
0  0  0  0  0  0  0  0
0  0  0  0  0  0  0  0
0  0  0  0  0  0  0 26
0  0  0  0  0  0 26  1
0  0  0  0  0 30  3 22
0  0  0  0  0  0 21 22
0  0  0  0  0 30 32 29
0  0  0  0  0  0  0  0