20
8
0  0  0  0  0  0  0 21
0  0  0  0  0  0  0 21
0  0  0  0  0  0 26  1
0  0  0  0  0  0 21 22
0  0  0  0  0  0 21 22
0  0  0  0  0  0 21 22
0  0  0  0  0 26  1 22
0  0  0  0  0 21 22 22
0  0  0  0  0 21 22 22
0  0  0  0 26  1 22 22
0 23  0  0 27  2 22 22
0 25  0  0  0 21 22 22
0  0  0  0  0 21 22 22
0  0  0  0 26  1 22 22
0  0  0 26  1 22 22 22
0  0  0 21 22 22 22 22
0  0  0 21 22 22 22 22
0  0 30  4 29  2 22 22
0  0  0  0  0 27 29  2
0  0  0  0  0  0  0 21