27
8
0  0  0  0  0  0  0 21
0  0  0  0  0  0 11 27
0  0  0  0  0  0  0  0
0  0  0  0  0  0  0  0
0  0  0  0  0  0  0  0
0  0  0  0  0  0  0  0
0  0  0  0  0 23  0  0
0  0  0  0  0 25  0  0
0  0  0  0  0  0  0  0
0  0  0  0  0  0  0  0
0  0  9 23  0  0  0 26
0  0  0 24  0  0 10 27
0  0  0 25  0  0  0  0
0  0  0  0  0  0  0  0
0  0  0  0  0  0 23  0
0  0  0  0  0  0 25  0
0  0  0  0  0  0  0  0
0  0  0  0  0  0  0  0
0  0  0  0  0  0  0  0
0  0  0  0  0  0  0  0
0  0  0  0  0  0  0 23
0  0  0  0  0  0  0 25
0  0  0  0  0  0  0  0
0  0  0  0  0  0  0  0
0  0  0  0  0 30 33 31
0  0  0  0  0  0  9 21
0  0  0  0  0  0  0 21