20
8
0  0  0  0  0  0  0 21
0  0  0  0  0  0  0 21
0  0  0  0  0  0 21 21
0  0  0  0  0  0 21 21
0  0  0  0  0  0 21 21
0  0  0  0  0  0  0  0
0  0  0  0  0  0  0  0
0  0  0  0  0  0 21 21
0  0  0  0  0  0 21 21
0  0  0  0  0 21 21 21
0  0  0  0  0  0  0 21
0  0  0  0  0  0 21 21
0  0  0  0  0  0  0  0
0  0  0  0  0  0  0  0
0  0  0  0  0  0  0 21
0  0  0  0  0  0 21 21
0  0  0  0  0 21 21 21
0  0  0  0  0  0 21 21
0  0  0  0  0 21 21 21
0  0  0  0  0  0  0  0